//鹤的个人词库，供 老用户 参考，根据自己情况调整
//win版：
//1. oqm 隐藏全码字
//2. omb 右键“用户”词库分类→导入本文件
//安卓版：
//1. ojj 选择“熟手”
//2.“个人词库”部分放进用户词库 oiz 生效

//----个人词库----
摸	mo#删
末	mo
抹	mof#删
摸	mof
拉	la
啦	la#删
啦	lak#固
回改	hgj
词频	cpv
优先	yxn
优先	yzxm#删
制定	vidk#删
大错	daco#删
政权	vgqr#删
神祇	ufqi#删
视线	uixm#删
视线	uxs
树立	uuli#删
忌讳	jihv#删
同志	tsvi#删
部队	budv#删
嫉妒	jidu#删
嫉妒	jdn
云南	yynj#删
勿施于人	wuyr#删
面前	mmqm#删
只是	vu#删
今晚	jbwj#删
显示	xmui#删
主义	vuyi#删
便宜	pmyi#删
便宜	pyb
偏移	pmyi
切分	qf
非常	fwih#删
肥肠	fwih
精彩	jkcd#删
荆	jkc#删
荆	jkcd
短线	dx
军衔	jyxm#删

大概	d#删
打	d
便宜	p#删
皮肤	p
其他	q#删
期	q
前天	qt#删
其他	qt
直接	v#删
之	v
直接	vj
整句	vj#删
整句	vjb
位置	w#删
位	w
位置	wv#固
为止	wv#删
位置	wwvi#删
为止	wwvi

//----一简词----
安装	a
比较	b
词库	c
嗯嗯	e
复杂	f
关系	g
忽略	h
重新	i
键盘	j
可以	k
理解	l
目录	m
内容	n
哦哦	o
然后	r
所有	s
提供	t
时候	u
显示	x
有时	y
自动	z

//------删全码词------
修正	xqvg#删
即可	jike#删
知道	vidc#删
只能	ving#删
简单	jmdj#删
计算	jisr#删
一下	yixx#删
一直	yivi#删
只是	viui#删
按时	anui#删
而是	erui#删
成为	igww#删
小时	xnui#删
简直	jmvi#删
任务	rfwu#删
时间	uijm#删
水平	uvpk#删
试试	uiui#删
神似	ufsi#删
传统	irts#删
台湾	tdwj#删
反应	fjyk#删
每周	mwvz#删
联系	lmxi#删
现金	xmjb#删
期间	qijm#删
极其	jiqi#删
在线	zdxm#删
只会	vihv#删
一片	yipm#删
美丽	mwli#删
想想	xlxl#删
按到	andc#删
微软	wwrr#删
刻意	keyi#删
即使	jiui#删
回忆	hvyi#删
华为	hxww#删
一边	yibm#删
两边	llbm#删
整句	vgju#删
按键	anjm#删
单元	djyr#删
反思	fjsi#删
大于	dayu#删
改编	gdbm#删
打架	dajx#删
叫唤	jnhr#删
尝尝	ihih#删
背景	bwjk#删
伤害	uhhd#删
程度	igdu#删
附件	fujm#删
世纪	uiji#删
假如	jxru#删
统一	tsyi#删
不再	buzd#删
猥琐	wwso#删
险恶	xmee#删
恶毒	eedu#删
达到	dadc#删
回复	hvfu#删
链接	lmjp#删
束缚	uufu#删
征服	vgfu#删
歧视	qiui#删
为止	wwvi#删
瑕疵	xxci#删
微信	wwxb#删
反悔	fjhv#删
补全	buqr#删
举例	juli#删
音形	ybxk#删
导出	dciu#删
把守	bauz#删
把戏	baxi#删
报仇	bciz#删
宝剑	bcjm#删
保鲜	bcxm#删
拜年	bdnm#删
摆脱	bdto#删
鼻塞	bise#删
编程	bmig#删
辩解	bmjp#删
便签	bmqm#删
表哥	bnge#删
博学	boxt#删
波音	boyb#删
憋屈	bpqu#删
背部	bwbu#删
杯子	bwzi#删
猜忌	cdji#删
伺候	cihz#删
餐馆	cjgr#删
残局	cjju#删
惨死	cjsi#删
撺掇	crdo#删
存管	cygr#删
搭车	daie#删
打理	dali#删
倒逼	dcbi#删
呆板	ddbj#删
代购	ddgz#删
带回	ddhv#删
代驾	ddjx#删
得志	devi#删
得以	deyi#删
登记	dgji#删
当众	dhvs#删
地痞	dipi#删
淡季	djji#删
顶住	dkvu#删
屌丝	dnsi#删
跌价	dpjx#删
断点	drdm#删
短篇	drpm#删
短线	drxm#删
动机	dsji#删
独唱	duih#删
独自	duzi#删
对账	dvvh#删
儿媳	erxi#删
发货	faho#删
发型	faxk#删
发炎	fayj#删
分割	ffge#删
粉红	ffhs#删
分界	ffjp#删
奋力	ffli#删
分神	ffuf#删
奉献	fgxm#删
访客	fhke#删
防守	fhuz#删
防伪	fhww#删
反腐	fjfu#删
凡人	fjrf#删
反之	fjvi#删
抚慰	fuww#删
费时	fwui#删
飞舞	fwwu#删
搞鬼	gcgv#删
高超	gcic#删
搞清	gcqk#删
鸽子	gezi#删
钢笔	ghbi#删
纲要	ghyc#删
光纤	glxm#删
国徽	gohv#删
国民	gomb#删
裹挟	goxp#删
聒噪	gozc#删
惯例	grli#删
关头	grtz#删
公会	gshv#删
共计	gsji#删
功名	gsmk#删
攻破	gspo#删
共用	gsys#删
公子	gszi#删
古文	guwf#删
桂花	gvhx#删
龟速	gvsu#删
浩瀚	hchj#删
豪绅	hcuf#删
何妨	hefh#删
何尝	heih#删
汉奸	hjjm#删
皇权	hlqr#删
火势	houi#删
换了	hrle#删
换手	hruz#删
回报	hvbc#删
徽章	hvvh#删
滑雪	hxxt#删
后腿	hztv#删
后市	hzui#删
插画	iahx#删
查出	iaiu#删
撤诉	iesu#删
车展	ievj#删
城堡	igbc#删
诚实	igui#删
诚信	igxb#删
尝到	ihdc#删
长篇	ihpm#删
场子	ihzi#删
迟了	iile#删
创伤	iluh#删
传导	irdc#删
冲高	isgc#删
重组	iszu#删
橱柜	iugv#删
初衷	iuvs#删
出于	iuyu#删
春节	iyjp#删
踌躇	iziu#删
浆糊	jlhu#删
极为	jiww#删
奖金	jljb#删
剑鞘	jmqn#删
监听	jmtk#删
浇灌	jngr#删
接口	jpkz#删
解围	jpww#删
纠葛	jqge#删
军师	jyui#删
客服	kefu#删
堪称	kjig#删
快了	kkle#删
空缺	ksqt#删
亏钱	kvqm#删
喟叹	kvtj#删
跨过	kxgo#删
扣缴	kzjn#删
扣税	kzuv#删
老实	lcui#删
理发	lifa#删
理工	ligs#删
零星	lkxk#删
连同	lmts#删
列支	lpvi#删
榴莲	lqlm#删
乱象	lrxl#删
聋子	lszi#删
履行	lvxk#删
论剑	lyjm#删
毛线	mcxm#删
毛衣	mcyi#删
迈过	mdgo#删
迈出	mdiu#删
迈入	mdru#删
懵逼	mgbi#删
蜜蜂	mifg#删
秘籍	miji#删
满族	mjzu#删
明知	mkvi#删
明晰	mkxi#删
免礼	mmli#删
免谈	mmtj#删
末位	moww#删
木板	mubj#删
美食	mwui#删
年级	nmji#删
碾碎	nmsv#删
奴隶	nuli#删
内侧	nwce#删
内里	nwli#删
牌照	pdvc#删
派息	pdxi#删
盘升	pjug#删
瓶颈	pkjk#删
漂移	pnyi#删
颇费	pofw#删
破例	poli#删
岂不	qibu#删
清静	qkjk#删
青涩	qkse#删
情谊	qkyi#删
枪毙	qlbi#删
墙纸	qlvi#删
潜力	qmli#删
嵌套	qmtc#删
瞧瞧	qnqn#删
权力	qrli#删
全套	qrtc#删
取笑	quxn#删
忍了	rfle#删
任职	rfvi#删
韧性	rfxk#删
若是	roui#删
乳汁	ruvi#删
入眼	ruyj#删
私信	sixb#删
司仪	siyi#删
散布	sjbu#删
三维	sjww#删
索贿	sohv#删
所幸	soxk#删
算出	sriu#删
算术	sruu#删
俗世	suui#删
随即	svji#删
叨扰	tcrc#删
抬高	tdgc#删
特制	tevi#删
剔除	tiiu#删
体制	tivi#删
体温	tiwf#删
毯子	tjzi#删
停播	tkbo#删
跳高	tngc#删
跳空	tnks#删
条约	tnyt#删
拖鞋	toxp#删
童话	tshx#删
同城	tsig#删
通气	tsqi#删
同事	tsui#删
腿部	tvbu#删
推导	tvdc#删
退费	tvfw#删
偷窥	tzkv#删
投降	tzxl#删
傻了	uale#删
涉及	ueji#删
赊账	uevh#删
深化	ufhx#删
神坛	uftj#删
身姿	ufzi#删
剩菜	ugcd#删
升幅	ugfu#删
生姜	ugjl#删
生理	ugli#删
声明	ugmk#删
上场	uhih#删
使馆	uigr#删
使坏	uihk#删
闪亮	ujll#删
说道	uodc#删
书信	uuxb#删
水利	uvli#删
收到	uzdc#删
收工	uzgs#删
收货	uzho#删
收集	uzji#删
受理	uzli#删
手拿	uzna#删
手下	uzxx#删
照办	vcbj#删
着凉	vcll#删
朝霞	vcxx#删
债券	vdqr#删
宅子	vdzi#删
哲理	veli#删
只管	vigr#删
值钱	viqm#删
质问	viwf#删
战线	vjxm#删
撞车	vlie#删
转圜	vrhr#删
转头	vrtz#删
专项	vrxl#删
专研	vryj#删
仲裁	vscd#删
终点	vsdm#删
重力	vsli#删
忠实	vsui#删
中心	vsxb#删
主体	vuti#删
注释	vuui#删
坠毁	vvhv#删
皱起	vzqi#删
外接	wdjp#删
外壳	wdke#删
外貌	wdmc#删
外甥	wdug#删
文殊	wfuu#删
蚊子	wfzi#删
王八	whba#删
旺季	whji#删
往上	whuh#删
王者	whve#删
网友	whyz#删
晚了	wjle#删
玩转	wjvr#删
玩意	wjyi#删
微风	wwfg#删
心算	xbsr#删
幸好	xkhc#删
行程	xkig#删
性急	xkji#删
醒了	xkle#删
兴致	xkvi#删
想必	xlbi#删
享福	xlfu#删
相连	xllm#删
象棋	xlqi#删
相思	xlsi#删
相通	xlts#删
巷子	xlzi#删
消化	xnhx#删
泄漏	xplz#删
雄起	xsqi#删
兄长	xsvh#删
雄伟	xsww#删
续保	xubc#删
虚实	xuui#删
下蛋	xxdj#删
药店	ycdm#删
钥匙	ycui#删
阉割	yjge#删
严厉	yjli#删
远离	yrli#删
油锅	yzgo#删
杂质	zavi#删
造反	zcfj#删
造就	zcjq#删
糟了	zcle#删
早起	zcqi#删
宰客	zdke#删
字符	zifu#删
自贡	zigs#删
资深	ziuf#删
资讯	zixy#删
作假	zojx#删
做了	zole#删
踪迹	zsji#删
宗旨	zsvi#删
纵向	zsxl#删
纵有	zsyz#删
阻止	zuvi#删
走近	zzjb#删
彩蛋	cddj#删
过渡	godu#删
好吗	hcma#删
何时	heui#删
哪边	nabm#删
哪次	naci#删
哪点	nadm#删
哪儿	naer#删
哪个	nage#删
哪里	nali#删
哪天	natm#删
哪种	navs#删
哪位	naww#删
哪些	naxp#删
哪样	nayh#删
倒是	dcui#删
登陆	dglu#删
低效	dixn#删
胆子	djzi#删
反查	fjia#删
高速	gcsu#删
高效	gcxn#删
国情	goqk#删
官网	grwh#删
活着	hove#删
话费	hxfw#删
超卖	icmd#删
卖点	mddm#删
卖家	mdjx#删
卖票	mdpn#删
卖主	mdvu#删
命名	mkmk#删
每期	mwqi#删
没人	mwrf#删
赏赐	uhci#删
谁知	uvvi#删
稳健	wfjm#删
拥护	yshu#删
宗师	zsui#删
按理	anli#删
黯然	anrj#删
暗自	anzi#删
五笔	wubi#删
座位	zoww#删
妥妥当当	ttdd#删
博而不精	bebj#删
白日飞升	brfu#删
不着边际	bvbj#删
嘟嘟囔囔	ddnn#删
分门别类	fmbl#删
飞扬跋扈	fybh#删
隔岸观火	gagh#删
高屋建瓴	gwjl#删
花繁叶茂	hfym#删
金发碧眼	jfby#删
将功补过	jgbg#删
将计就计	jjjj#删
济济一堂	jjyt#删
迷迷糊糊	mmhh#删
美若天仙	mrtx#删
破破烂烂	ppll#删
千娇百媚	qjbm#删
人欢马叫	rhmj#删
扰人清梦	rrqm#删
条条框框	ttkk#删
甜甜蜜蜜	ttmm#删
头痛欲裂	ttyl#删
深情厚谊	uqhy#删
时日无多	urwd#删
食色性也	usxy#删
生死攸关	usyg#删
我必犯人	wbfr#删
为期不远	wqby#删
万丈深渊	wvuy#删
毋庸讳言	wyhy#删
霞光万道	xgwd#删
有法必依	yfby#删
一飞冲天	yfit#删
一清二白	yqeb#删
一物降一物	ywxw#删
余情未了	yqwl#删
自毁长城	zhii#删
自取其辱	zqqr#删
在情在理	zqzl#删
百思不得其解	bsbj#删
横挑鼻子竖挑眼	htby#删
回头一笑百媚生	htyu#删
吃香的喝辣的	ixdd#删
临时抱佛脚	lubj#删
摸着石头过河	mvuh#删
十年生死两茫茫	unum#删
睁只眼闭只眼	vvyy#删
无规矩不成方圆	wgjy#删
一亩三分地	ymsd#删
一年之计在于春	ynvi#删
远亲不如近邻	yqbl#删
一朝权在手	yvqu#删
一问三不知	ywsv#删